1 1 1 1 3 3 1 1 1 1 1 1 1 1 1 1 1 1 1 1
3 8 1 1 1 1 1 2 2 1 1 1 1 1 1 1 1 1 1 1
1 7 8 1 1 1 2 1 1 2 1 1 1 1 1 1 1 1 1 1
1 1 7 8 2 2 1 1 1 1 2 2 2 2 2 1 1 1 1 1
1 1 1 7 8 1 1 1 1 1 1 1 1 1 3 1 1 1 1 1
1 1 1 1 2 2 1 1 1 1 1 1 1 1 2 1 1 1 1 1
1 1 1 1 2 1 1 1 1 1 1 1 1 1 2 1 1 1 1 1
1 1 1 5 6 1 1 1 1 1 1 1 1 1 2 1 1 1 1 1
1 1 5 6 1 1 1 1 1 1 1 1 1 1 2 1 1 1 1 1
1 5 6 1 1 1 1 1 1 1 1 1 1 1 2 1 1 1 1 1
1 2 1 1 1 1 1 1 1 1 1 1 1 1 2 1 1 1 1 1
1 2 1 1 1 1 1 1 1 1 1 1 1 1 3 1 1 1 1 1
3 6 1 1 1 1 1 1 1 1 1 1 1 2 1 1 1 1 1 1
1 2 1 1 1 1 1 1 1 1 1 1 2 1 1 1 1 1 1 1
1 2 1 1 1 1 1 1 1 1 1 2 1 1 1 1 1 1 1 1
1 1 2 1 1 1 1 1 1 1 2 1 1 1 1 1 1 1 1 1
1 1 1 2 1 1 1 1 1 2 1 1 1 1 1 1 1 1 1 1
1 1 1 1 2 1 2 2 2 1 1 1 1 1 1 1 1 1 1 1
1 1 1 1 1 2 1 1 1 1 1 1 1 1 1 1 1 1 1 1
1 1 1 1 1 1 1 1 1 1 1 1 1 1 1 1 2 2 2 2