2 4 4 4 4 4 4 4 4 4 4 4 4 4 4 4 4 4 4 2
1 1 1 1 1 1 1 1 1 1 1 1 1 1 1 1 1 1 1 1
1 7 8 1 3 7 6 1 7 8 1 1 1 1 1 1 1 7 8 1
1 1 7 8 7 8 1 1 1 7 4 4 4 4 8 1 1 1 3 1
1 1 1 7 8 7 8 1 1 1 1 1 1 1 3 1 1 1 3 1
1 1 1 1 3 1 7 8 1 1 1 1 1 1 3 1 1 1 3 1
1 1 1 1 3 1 1 7 8 1 1 1 1 1 2 4 4 4 6 1
1 1 1 5 6 1 1 1 7 8 1 1 1 1 3 1 1 1 1 1
1 1 5 6 1 1 1 1 1 7 8 1 1 1 3 1 1 1 1 1
1 5 6 1 1 1 1 1 1 1 3 1 1 1 3 1 1 1 1 1
1 3 1 1 1 1 1 1 1 1 3 1 1 1 3 1 1 1 1 1
1 3 1 1 1 1 1 1 1 1 3 1 1 5 2 1 1 1 1 1
2 6 1 1 1 1 1 1 1 1 3 1 1 3 3 1 1 1 1 1
7 8 1 1 1 1 1 1 1 1 7 4 4 6 3 1 1 1 1 1
1 7 4 4 4 8 1 1 1 1 1 1 1 1 3 1 1 1 1 1
1 1 1 1 1 7 4 4 8 1 1 1 1 1 3 1 1 1 1 1
1 1 1 1 1 1 1 1 7 4 4 4 4 4 6 1 1 1 1 1
1 1 1 1 1 1 1 1 1 1 1 1 1 1 1 1 1 1 1 1
1 1 1 1 1 1 1 1 1 1 1 1 1 1 1 1 1 1 1 1
1 1 1 1 1 1 1 1 1 1 1 1 1 1 1 1 1 1 1 1