1 1 5 4 4 4 4 4 4 4 4 4 4 4 4 4 4 8 1 1
5 4 2 1 1 1 1 1 1 1 1 1 1 1 1 1 1 2 4 8
3 1 7 8 1 1 1 1 1 1 1 1 1 1 1 1 1 3 1 3
3 1 1 7 8 1 1 1 1 1 1 1 1 1 1 1 5 6 1 3
3 1 1 1 3 1 1 1 1 1 1 1 1 1 1 5 6 1 1 3
3 1 1 1 3 1 1 1 1 1 1 1 1 1 1 3 1 1 1 3
3 1 1 1 7 4 2 4 4 4 4 4 4 2 4 6 1 1 1 3
3 1 1 1 1 1 3 1 1 1 1 1 1 3 1 1 1 1 1 3
3 1 1 1 1 1 3 1 1 1 1 1 1 3 1 1 1 1 1 3
3 1 1 1 1 1 3 1 1 1 1 1 1 3 1 1 1 1 1 3
3 1 1 1 1 1 3 1 1 1 1 1 1 3 1 1 1 1 1 3
3 1 1 1 1 1 3 1 1 1 1 1 1 3 1 1 1 1 1 3
3 1 1 1 1 1 3 1 1 1 1 1 1 3 1 1 1 1 1 3
3 1 1 1 5 4 2 4 4 4 4 4 4 2 4 8 1 1 1 3
3 1 1 1 3 1 1 1 1 1 1 1 1 1 1 3 1 1 1 3
3 1 1 5 6 1 1 1 1 1 1 1 1 1 1 7 8 1 1 3
3 1 5 6 1 1 1 1 1 1 1 1 1 1 1 1 7 8 1 3
3 1 3 1 1 1 1 1 1 1 1 1 1 1 1 1 1 3 1 3
7 4 2 1 1 1 1 1 1 1 1 1 1 1 1 1 1 2 4 6
1 1 7 4 4 4 4 4 4 4 4 4 4 4 4 4 4 6 1 1