2 4 4 2 4 4 4 4 4 2 4 4 4 4 4 2 4 4 4 2
3 1 1 3 1 1 1 1 1 3 1 1 1 1 1 1 3 1 1 3
3 1 1 3 1 1 1 1 1 3 1 1 1 1 1 1 3 1 1 3
3 1 1 3 1 1 1 1 1 3 1 1 1 1 1 1 3 1 1 3
3 1 1 3 1 1 1 1 1 3 1 1 1 1 1 1 2 1 1 3
2 1 1 2 4 4 4 4 4 2 4 4 4 4 4 4 2 1 1 2
3 1 1 3 1 1 1 1 1 3 1 1 1 1 1 1 3 1 1 3
3 1 1 3 1 1 1 1 1 3 1 1 1 1 1 1 3 1 1 3
3 1 1 3 1 1 1 1 1 3 1 1 1 1 1 1 3 1 1 3
2 4 4 2 4 4 4 4 4 2 4 4 4 4 4 4 2 4 4 2
3 1 1 3 1 1 1 1 1 3 1 1 1 1 1 1 3 1 1 3
3 1 1 3 1 1 1 1 1 3 1 1 1 1 1 1 3 1 1 3
3 1 1 3 1 1 1 1 1 3 1 1 1 1 1 1 3 1 1 3
2 1 1 2 4 4 4 4 4 2 4 4 4 4 4 4 2 1 1 3
3 1 1 3 1 1 1 1 1 3 1 1 1 1 1 1 1 1 1 3
3 1 1 3 1 1 1 1 1 3 1 1 1 1 1 1 1 1 1 3
3 1 1 3 1 1 1 1 1 3 1 1 1 1 1 1 1 1 1 3
3 1 1 3 1 1 1 1 1 3 1 1 1 1 1 1 1 1 1 3
3 1 1 3 1 1 1 1 1 3 1 1 1 1 1 1 1 1 1 3
2 4 4 2 4 4 4 4 4 2 4 4 4 4 4 2 4 4 4 2